well      sample name         year                specimen_ID         barcode             
A1        PB1                 NaN                 NaN                 NaN                 
A2        EC1                 NaN                 NaN                 NaN                 
A3        S1                  2004                49                  27595770            
A4        S2                  2004                50                  79137553            
A5        S3                  1988                437                 55590204            
A6        S4                  1988                438                 29631124            
A7        S5                  1984                923                 12302628            
A8        S6                  1984                924                 18649093            
A9        S7                  NaN                 NaN                 NaN                 
A10       S8                  NaN                 NaN                 NaN                 
A11       S9                  NaN                 NaN                 NaN                 
A12       S10                 NaN                 NaN                 NaN                 
B1        S11                 NaN                 NaN                 NaN                 
B2        PO1                 NaN                 NaN                 NaN                 
B3        EC2                 NaN                 NaN                 NaN                 
B4        S12                 NaN                 NaN                 NaN                 
B5        S13                 NaN                 NaN                 NaN                 
B6        S14                 NaN                 NaN                 NaN                 
B7        S15                 NaN                 NaN                 NaN                 
B8        S16                 NaN                 NaN                 NaN                 
B9        S17                 NaN                 NaN                 NaN                 
B10       S18                 NaN                 NaN                 NaN                 
B11       S19                 NaN                 NaN                 NaN                 
B12       S20                 NaN                 NaN                 NaN                 
C1        S21                 NaN                 NaN                 NaN                 
C2        S22                 NaN                 NaN                 NaN                 
C3        PB2                 NaN                 NaN                 NaN                 
C4        EC3                 NaN                 NaN                 NaN                 
C5        S23                 NaN                 NaN                 NaN                 
C6        S24                 NaN                 NaN                 NaN                 
C7        S25                 NaN                 NaN                 NaN                 
C8        S26                 NaN                 NaN                 NaN                 
C9        S27                 NaN                 NaN                 NaN                 
C10       S28                 NaN                 NaN                 NaN                 
C11       S29                 NaN                 NaN                 NaN                 
C12       S30                 NaN                 NaN                 NaN                 
D1        S31                 NaN                 NaN                 NaN                 
D2        S32                 NaN                 NaN                 NaN                 
D3        S33                 NaN                 NaN                 NaN                 
D4        PO2                 NaN                 NaN                 NaN                 
D5        EC4                 NaN                 NaN                 NaN                 
D6        S34                 NaN                 NaN                 NaN                 
D7        S35                 NaN                 NaN                 NaN                 
D8        S36                 NaN                 NaN                 NaN                 
D9        S37                 NaN                 NaN                 NaN                 
D10       S38                 NaN                 NaN                 NaN                 
D11       S39                 NaN                 NaN                 NaN                 
D12       S40                 NaN                 NaN                 NaN                 
E1        S41                 NaN                 NaN                 NaN                 
E2        S42                 NaN                 NaN                 NaN                 
E3        S43                 NaN                 NaN                 NaN                 
E4        S44                 NaN                 NaN                 NaN                 
E5        PB3                 NaN                 NaN                 NaN                 
E6        EC5                 NaN                 NaN                 NaN                 
E7        S45                 NaN                 NaN                 NaN                 
E8        S46                 NaN                 NaN                 NaN                 
E9        S47                 NaN                 NaN                 NaN                 
E10       S48                 NaN                 NaN                 NaN                 
E11       S49                 NaN                 NaN                 NaN                 
E12       S50                 NaN                 NaN                 NaN                 
F1        S51                 NaN                 NaN                 NaN                 
F2        S52                 NaN                 NaN                 NaN                 
F3        S53                 NaN                 NaN                 NaN                 
F4        S54                 NaN                 NaN                 NaN                 
F5        S55                 NaN                 NaN                 NaN                 
F6        PO3                 NaN                 NaN                 NaN                 
F7        EC6                 NaN                 NaN                 NaN                 
F8        S56                 NaN                 NaN                 NaN                 
F9        S57                 NaN                 NaN                 NaN                 
F10       S58                 NaN                 NaN                 NaN                 
F11       S59                 NaN                 NaN                 NaN                 
F12       S60                 NaN                 NaN                 NaN                 
G1        S61                 NaN                 NaN                 NaN                 
G2        S62                 NaN                 NaN                 NaN                 
G3        S63                 NaN                 NaN                 NaN                 
G4        S64                 NaN                 NaN                 NaN                 
G5        S65                 NaN                 NaN                 NaN                 
G6        S66                 NaN                 NaN                 NaN                 
G7        PB4                 NaN                 NaN                 NaN                 
G8        EC7                 NaN                 NaN                 NaN                 
G9        S67                 NaN                 NaN                 NaN                 
G10       S68                 NaN                 NaN                 NaN                 
G11       S69                 NaN                 NaN                 NaN                 
G12       S70                 NaN                 NaN                 NaN                 
H1        S71                 NaN                 NaN                 NaN                 
H2        S72                 NaN                 NaN                 NaN                 
H3        S73                 NaN                 NaN                 NaN                 
H4        S74                 NaN                 NaN                 NaN                 
H5        S75                 NaN                 NaN                 NaN                 
H6        S76                 NaN                 NaN                 NaN                 
H7        S77                 NaN                 NaN                 NaN                 
H8        PO4                 NaN                 NaN                 NaN                 
H9        EC8                 NaN                 NaN                 NaN                 
H10       S78                 NaN                 NaN                 NaN                 
H11       S79                 NaN                 NaN                 NaN                 
H12       S80                 NaN                 NaN                 NaN                 
